############################################
#                                          #
# ### ### ####### ######## ####### ### ### #
# #     #       #   ####   #       #     # #
# # ### # ### # # # #### # # # ### # ### # #
    #   # #   #     ####     #   # #   #    
  # # ### # # ### ######## ### # # ### # #  
# #         # #              # #         # #
# ### # # ### # # ######## # # ### # # ### #
#       #   #   # ######## #   #   #       #
# # # ### # # # # ######## # # # # ### # # #
#   #     #   # #          # #   #     #   #
# ##### # # ### # ######## # ### # # ##### #
#       # #   # #   ####   # #   # #       #
# ### # # # # # # # #### # # # # # # # ### #
#   # # # # #     #      #     # # # # #   #
# # # # # # ### ############ ### # # # # # #
#   # # #   #                  #   # # #   #
# ### # # # # ### ######## ### # # # # ### #
      #   #     # #      # #     #   #      
# ### # # ### # # # #### # # # ### # # ### #
#                                          #
############################################
