############################################################################################################################
#                                                                                                                          #
# ### # # ### ##### ##### ####### ### ####### # ####### # # #### # # ####### # ####### ### ####### ##### ##### ### # # ### #
# ### # # ###   #   #####         ###       # #         #   ####   #         # #       ###         #####   #   ### # # ### #
# ### # # ### # # # ##### # ##### ### # # # # # ### # ################ # ### # # # # # ### ##### # ##### # # # ### # # ### #
#     #   ### #   # ##### # #   #     # # #   #   # #                  # #   #   # # #     #   # # ##### #   # ###   #     #
# # # ####### # ### ##### # # # # # ### # ### # # # ####### #### ####### # # # ### # ### # # # # # ##### ### # ####### # # #
# # #         #   #       # #   # #     # #   # #           ####           # #   # #     # #   # #       #   #         # # #
# # ### ##### # # # ### # # ##### ### # # # # # # # ####### #### ####### # # # # # # # ### ##### # # ### # # # ##### ### # #
# # #   #   # # #   #   # #       #   # #   #   # #         ####         # #   #   # #   #       # #   #   # # #   #   # # #
  # # # # # # # # # # ### # # # # # ### # # ### # ### # # # #### # # # ### # ### # # ### # # # # # ### # # # # # # # # # #  
# #   # #   #   # #         # # #     #   # #   #     #   # #### #   #     #   # #   #     # # #         # #   #   # #   # #
# # ### ##### # # ### ### ### # ### # # # # # # # # ####### #### ####### # # # # # # # # ### # ### ### ### # # ##### ### # #
#     #       # #     ###   # # #   #   # #   #   #                      #   #   # #   #   # # #   ###     # #       #     #
# # # # # # ### # # # ### # # # # ####### # ### ##### # ############ # ##### ### # ####### # # # # ### # # # ### # # # # # #
#   #   # #       # #     #   #           #   #       # ############ #       #   #           #   #     # #       # #   #   #
# ####### ### # ### # # ### # # # # ### # # # # # # ### ############ ### # # # # # # ### # # # # ### # # ### # ### ####### #
#         #   #     # #     #     # #   #   #   # #     ############     # #   #   #   # #     #     # #     #   #         #
# # ### # # # # ### # ### # ### ### # ### ####### ### # ############ # ### ####### ### # ### ### # ### # ### # # # # ### # #
  # #   #   # # ### #     #       #     #         #   #              #   #         #     #       #     # ### # #   #   # #  
# # # ### ### # ### # # # ####### # # # # # ##### # ### # ######## # ### # ##### # # # # # ####### # # # ### # ### ### # # #
# #         # #       # #           # #   #   #       # #   ####   # #       #   #   # #           # #       # #         # #
# # ####### # # # # ### ### ### ### # # ##### # # # # # ### #### ### # # # # # ##### # # ### ### ### ### # # # # ####### # #
# #               #   #       #   # # #           # #       ####       # #           # # #   #       #   #               # #
  # # ### # # # ### # # ##### # # # # # # ##### ### ### # ######## # ### ### ##### # # # # # # ##### # # ### # # # ### # #  
#   # #   #   #   # #   #####   #   # # # #   #         #          #         #   # # # #   #   #####   # #   #   #   # #   #
# ### # ####### # # # # ##### ### # # # # # # # # ### ##### #### ##### ### # # # # # # # # ### ##### # # # # ####### # ### #
#               #   # # #####     #     # #   # #   #       ####       #   # #   # #     #     ##### # #   #               #
# ### # # ### ##### # # ##### # # ### # # ##### # # # ### ######## ### # # # ##### # # ### # # ##### # # ##### ### # # ### #
#   # # # ###       # #       # # #   # #       # #   ###   ####   ###   # #       # #   # # #       # #       ### # # #   #
# # # # # ### # ### # # ### # # # # ### # # ### # # # ### # #### # ### # # # ### # # ### # # # # ### # # ### # ### # # # # #
# #   #   ### # #     # #   # # #     #   #   # # #   ### #      # ###   # # #   #   #     # # #   # #     # # ###   #   # #
# # # ####### # # # # # # ### # # # # # # ### # # ####### ######## ####### # # ### # # # # # # ### # # # # # # ####### # # #
  # #         #     #         # #   #   # #   #           #      #           #   # #   #   # #         #     #         # #  
# # ####### # # # ### # # ### # # ####### # ### ####### # # #### # # ####### ### # ####### # # ### # # ### # # # ####### # #
# #         # # #     # # ###                           #   ####   #                           ### # #     # # #         # #
# # # ##### # # # # # # # ### ##### ##### # ### ##### ################ ##### ### # ##### ##### ### # # # # # # # ##### # # #
#   # ##### #   # # # #   ###   #   ##### # ### #####                  ##### ### # #####   #   ###   # # # #   # ##### #   #
# # # ##### # # # # # ####### # # # ##### # ### ##### # ############ # ##### ### # ##### # # # ####### # # # # # ##### # # #
# # # ##### # # # # #         #   # ##### #     ##### #   #      #   # #####     # ##### #   #         # # # # # ##### # # #
# # # ##### # # # # # ##### ### ### ##### # # # ##### # # # #### # # # ##### # # # ##### ### ### ##### # # # # # ##### # # #
# # #         #   # # #####   #   #       #   #       # #   ####   # #       #   #       #   #   ##### # #   #         # # #
# # # # ### # # # # # ##### # # # # ##### # ### # # # # ### #### ### # # # # ### # ##### # # # # ##### # # # # # ### # # # #
# #   # #   # # #     ##### #   #   #   #     #   # # #     ####     # # #   #     #   #   #   # #####     # # #   # #   # #
# # # # # ### # ### # ##### ### # # # # # # # # ### # # ### #### ### # # ### # # # # # # # # ### ##### # ### # ### # # # # #
#   # #         #   #       #   # # #   # # #     # #   ### #### ###   # #     # # #   # # #   #       #   #         # #   #
# ### # ####### # ##### ### # # # # ##### # # # # # # # ### #### ### # # # # # # # ##### # # # # ### ##### # ####### # ### #
#     #       #           #   # # #       # # # #   # #              # #   # # # #       # # #   #           #       #     #
# ### # ##### # ### # # # # ### # # ##### # # # ### # # # ######## # # # ### # # # ##### # # ### # # # # ### # ##### # ### #
#   #   #####   #   #   #     #   #   #   # # #       # #   ####   # #       # # #   #   #   #     #   #   #   #####   #   #
  # # # ##### # # ####### # # # # # # # # # # # # ### # ### #### ### # ### # # # # # # # # # # # # ####### # # ##### # # #  
# #   # ##### #             #   #   #   #     # #   # #     ####     # #   # #     #   #   #   #             # ##### #   # #
  # # # ##### # ####### # ### # # ### ### # # # ### # # # ######## # # # ### # # # ### ### # # ### # ####### # ##### # # #  
# # # #       #         #     # #       #   #       #   #          #   #       #   #       # #     #         #       # # # #
  # # # # ### # ##### ### ### # # # ### # ##### # ### # ### #### ### # ### # ##### # ### # # # ### ### ##### # ### # # # #  
# # # # # ### # #####   #   # # # #   #         #     # #   ####   # #     #         #   # # # #   #   ##### # ### # # # # #
# # # # # ### # ##### # # # # # # ### # ####### ### ### # ######## # ### ### ####### # ### # # # # # # ##### # ### # # # # #
#   #   #       ##### #     # #       #         #     #     ####     #     #         #       # #     # #####       #   #   #
# # # # # ### # ##### ### ### # ### ### ### ### # ### # ### #### ### # ### # ### ### ### ### # ### ### ##### # ### # # # # #
  #   # # #   #                 ###     ### ###   #       #      #       #   ### ###     ###                 #   # # #   #  
# # ### # # # ### # ### ####### ### ### ### ### # # # ### # #### # ### # # # ### ### ### ### ####### ### # ### # # # ### # #
                                                                                                                            
############################################################################################################################
